WWWXLLWW
WWR-LLWW
W-------
F--FFFR-
F-FFFFF-
F-WWWLL-
F-WWWLL-
--------
RLLL-FFF
LLLL-FFF
-----FFF
WWLL----
WWLL-WRW
WWLLNWWW
